我相信 - 杨培安
救赎之旅 - 许巍
Old Town Road - Lil Nas X
Time to Go Home - Jacoo
心雨 - 周杰伦
时光机 - 周杰伦
不是因为寂寞才想你 - 王小帅
日落大道 - 梁博
Una Mattina - Ludovico Einaudi
Cloud 9 - GEMINI
King - Zayde Wølf
大笨钟 - 周杰伦
王妃 - 萧敬腾
China-Rain - 徐梦圆
Dancing With Your Ghost - Sasha Alex Sloan
One Thing - One Direction
除了春天爱情和樱花 - CMJ
Seasons in the Sun - Westlife
RISE - The Glitch Mob / Mako / The Word Alive
Serenade - Jim BrickmanN
ever Had A Dream Come True - S Club 7
追光者 - 岑宁儿
我要夏天 - 周杰伦 / 杨瑞代一路向北 - 周杰伦
Booty Music - Deep Side
We Are Never Ever Getting Back Together - Taylor Swift
Mother (映画「菊次郎の夏」より) - 久石让 (ひさいし じょう)
Timeless - Jim Brickman
演员 - 薛之谦
天使的翅膀 - 安琥
祖国 - 南征北战NZBZ
You're Beautiful - James Blunt
Sunny - Boney M.
此生不换 - 青鸟飞鱼
I Believe I Can Fly (Radio Edit) - R. Kelly
I Hate Myself for Loving You - Joan Jett & The Blackhearts
Visions - Acreix
Let Her Go - Passenger
Radioactive (Live At The Joint) - Imagine Dragons
EZ4ENCE (kannatuslaulu) - The Verkkars
Legends Never Die - 英雄联盟 / Against the Current
Shape of You - Ed Sheeran
李白 - 李荣浩
朋友 - 周华健
Glad You Came - The Wanted
Hold Back the River - Martin Ermen
心如止水 - Ice Paper
Innocence - Avril Lavigne
Love The Way You Lie - Various Artists
Infinity - One Direction
In The End - Linkin Park
Counting Stars - OneRepublic
Numb - Linkin Park
Let Me Down Slowly - Alec Benjamin / Alessia Cara
Lover Song - SoulFa灵魂沙发
大海 - 张雨生
My Heart Will Go On - Céline Dion
Maps - Maroon 5 / Big Sean
泡沫 - G.E.M. 邓紫棋
思い出の小箱 (回忆中的小箱) - 宗次郎 (そうじろう)
Bloom of Youth (风华正茂) - Key Sounds Label (キー・サウンズ・レーベル)
Pachelbel's Canon In D (钢琴独奏) - Brian Crain
Escape - Dripice
There For You - Martin Garrix / Troye Sivan
Welcome To New York - Taylor Swift
夜空中最亮的星 - 逃跑计划
Fire - Gavin DeGraw
7 Years - Lukas Graham
Paralyzed - NF
Galway Girl - Ed Sheeran
Because of You - Kelly Clarkson
If Everyone Cared - Nickelback
We Are The World - U.S.A. For Africa
The Nights - Avicii
富士山下 - 陈奕迅
Zoo Bop - X-Ray Dog
The Greatest Show - Hugh Jackman / Keala Settle / Zac Efron / Zendaya
最好的朋友在身边 - 娄艺潇
祝你一路顺风 - 吴奇隆
你不在 - EnjiA魏恩佳
