夏野与暗恋 - 闫东炜
In Time - Soulostar
你的答案 - 阿冗
Counting Stars (Deluxe Piano Interpretation) - The Piano Kings
Imagine - Soulostar
Dawn - Janji
Holiday - Tobu / Itro
Por Una Cabeza - Thomas Newman
The Ludlows - James Horner
Theme From Mission: Impossible - Mission Impossible
Fade - Alan Walker
QingHai Lake(མཚོ་སྔོན་པོ།) - Sonam
Roar - Katy Perry
Nuvole bianche - Ludovico Einaudi
Butterfly - Jhonn One
Rain After Summer - 羽肿
Here We Are Again (Inst.) - Cagnet (キャグネット)
Tassel - Cymophane
The Right Path - Thomas Greenberg
花火が瞬く夜に - 羽肿
Because of You - Josh Vietti
Empire of Angels - Thomas Bergersen
Where Is the Love - Josh Vietti
River Flows in You - Martin Ermen
夏恋 - Otokaze
Last Of The Wilds (Live at Wacken 2013) - Nightwish
With an Orchid - Yanni
Croatian Rhapsody (Arr. Bratos & Kazinoti) - Maksim / Nikša Bratoš / Remi Kazinoti / Craig Pruess
碎月雨中奏 - iw ix
A New Day (Inst.) - Various Artists
彩月 - Otokaze
Don't Push Me - Sweetbox
美丽的神话 - 孙楠 / 韩红
不得不爱 - 潘玮柏 / 弦子
我在那一角落患过伤风 - 冯曦妤
Love Story - Taylor Swift Tribute Band
New Soul - Vox Angeli
Kiss The Rain - 李闰珉 (이루마)
Take It From Me - The Weepies / Deb Talan / Steve Tannen
理想三旬 - 陈鸿宇
China-2 - Sand
温柔 - 五月天
少年他的奇幻漂流 - 五月天
男儿当自强 (国语) - 林子祥
Aloha Heja He - Achim Reichel
いつも何度でも (永远同在) - 宗次郎 (そうじろう)
Apologize (Remix) - Timbaland / OneRepublic
Lock Me Up - The Cab
July - 忧伤还是快乐 - 风吹心散
Champagne Ocean - Ehrling
Last Reunion - Peter Roe
七月上 - Jam
Yesterday Once More - Carpenters
Lemon Tree - Fool's Garden
Rainbow - Kacey Musgraves
The Sound of Silence - Simon & Garfunkel
The Sounds of Silence - Bandari
Summer（钢琴曲） - Mark .Kevin
Inspire - Capo Productions
和煦的糖果风 - Candy_Wind
Payphone - Maroon 5 / Wiz Khalifa
青石巷 - 魏琮霏
What Makes You Beautiful - One Direction
In The End (万人合唱版) - Linkin Park
Skin - Rag'N'Bone Man
自由飞翔 - 凤凰传奇
愿世界对你温柔相待 - 徐梦圆
白昼之夜 - 林隆璇
Windy Hill - 羽肿
China-X - 徐梦圆
ASpiral Moon - Sereno
海阔天空 - BEYOND
#Lov3 #Ngẫu Hứng - Hoaprox
青空 - Candy_Wind
Battle Without Honor Or Humanity - Tomoyasu Hotei
Awake - Lightscape
Lonely Dance - Vexento
Crush - Tessa Violet
生如夏花 - 朴树
平凡之路 - 朴树
Chain Hang Low - Jibbs
中国话 - S.H.E
Frontier (Cargo Remix) - Cargo / VINAI / SCNDL
温柔 - 五月天
我的天空 - 南征北战NZBZ
Nothing's Going to Change My Love For You - Westlife
隐形的翅膀 (Live) - 张韶涵
Far Away - CelDro
The Cure - Lady Gaga
Dream It Possible - Delacey
Memories - Jacoo
Summer (菊次郎的夏天) (PIANO VER.) - 久石让 (ひさいし じょう)
Super Star - S.H.E
Read All About It (Radio Edit) - Professor Green
Legend - The Score
Revolution - The Score
Poker Face - Lady Gaga
The Phoenix - Fall Out Boy
红玫瑰 - 陈奕迅
Far Away from Home - Groove Coverage
Please Don't Go - Joel Adams
光年之外 - G.E.M. 邓紫棋
一生所爱 (电影"西游记大结局之仙履奇缘"插曲) - 卢冠廷
Monody - TheFatRat / Laura Brehm
We Will Rock You - Queen
梦中的婚礼 - Richard Clayderman
来自天堂的魔鬼 - G.E.M. 邓紫棋
Snowdream - Bandari
Man At Arms - Position Music
Horizon - Janji
We Don't Talk Anymore - Charlie Puth / Selena Gomez
Never Be Alone - 会弹猫的吉他
Ngẫu Hứng - Hoaprox
Good Time - Owl City / Carly Rae Jepsen
Gates Of Dawn - Secret Garden
友谊地久天长 - 黑鸭子组合
Conquest of Paradise - Vangelis
青花瓷 - 周杰伦
发如雪 - 周杰伦
Mine - Taylor Swift
Soldier - Samantha Jade
What Are Words - Chris Medina
See You Again (feat. Charlie Puth) - Wiz Khalifa / Charlie Puth
模特 - 李荣浩
Windfall - TheFatRat
Immortals (From "Big Hero 6") - Fall Out Boy
曾经的你 - 许巍
冬天的秘密 - 周传雄
Let It Go (From "Frozen"|Single Version) - Demi Lovato
Zombies on Your Lawn - Laura Shigihara
Numb - Linkin Park

